16
16
*****lll********
*rrrr000mmm0000*
*rrr0000mmm0000*
*rr0000mmm00000*
l000000mm*00s00*
l0000mm00000000l
***mm0000000000l
*00000000000000l
***0*0000000000*
*0*0*0000000000*
*0*0*0000000000*
****************
***000***www****
***www***ww****w
**************ww
*************www
1
shortcut ahead
600
5
