16
16
****************
*000000000ggggg*
*0000000000gggg*
*000000000000gg*
*00000000*0000g*
l00000000000000l
l00000000000000l
l00000000000000l
***0*0000000000*
*0*0*0000000000*
*0*0*0000000000*
****************
***000***www****
***www***ww****w
**************ww
*************www
3
how are you today
this is a sign in grass
please say something different!
400
4