16
16
wwww********wwww
ww***ttttt***www
w**t0000ttt***ww
*ttttt000mttt***
*ttt00000000ttt*
l0s0000000000m0l
l00000000000000l
l00000000000000l
***t*0000000000*
*t*t*0000000000*
*t*t*0000000000*
****************
***000***www****
***www***ww****w
**************ww
*************www
1
go slow
600
3
