16
16
****************
*00000000000000*
*000000tTs0Ss00*
*00000000000000*
l00f00000*00000*
l00000000000000l
***000000000000l
*00000000000000l
***0*0000000000*
*0*0*0000000000*
*0*0*0000000000*
****************
***000***www****
***www***ww****w
**************ww
*************www
3
how are you today
this is a sign in grass
please say something different!